---------
-SOOOO---
-O---O---
-OOOOOE--
---------
